111111111111111
1             1
1 22222 22222 1
1 1   1 1   1 1
1 2 2 2 2 2 2 1
1   1   1   1 1
1 22222 22222 1
1             1
1 22222 22222 1
1 1   1 1   1 1
1 2 2 2 2 2 2 1
1   1   1   1 1
1 22222 22222 1
1             1
111111111111111